###########
S       # #
##### # # #
#     # # #
# ##### # #
#       # E
###########
