##########
#T#  %@  #
# # #### #
# # #  # #
#   #  # #
##### ## #
#O  # $$ #
##########
