###########
S       # #
##### # # #
#     # # #
# ##### # #
#       ##E
###########
