##########
#S########
# ########
# ########
# ########
# ########
# ########
# ########
########E#
##########
