########
S S    # 
#### # 
#  E  # 
# #### 
# E   E 
#######