###########
S       # #
##### # # #
#     # # #
# ##### # #
#       # #
###########
