###########
#       # #
##### # # #
#     # # #
# ##### # #
#       # E
###########
