########
S     # 
#### # 
#    # 
# #### 
#    E 
#######
