##########
#S#      #
# # #### #
# # #  # #
#   #  # #
##### ## #
#E  #    #
##########
