#S########
# #      #
# # #### #
# # #  # #
#      # #
##### ## #
#        #
#E########
